6,6,
1,1,1,1,1,1,
1,9,10,2,2,1,
1,0,3,11,11,1,
1,0,3,4,5,1,
-1,6,6,7,8,1,
1,1,1,1,1,1,
